000000000000000000000000000000000000000
078888888888878888888888808888888888800
078888888878878888878888808888878888800
077788888877878778888877808778888887700
07777777777c878777777777808777777777c00
077777777777878777777777808777777777700
077777777777878777777777808777777777700
078877777788878887777788808887777778800
080000000000080000000000000000000000000
078888888888878888888888808888888888800
078888888878878888888888808888878888800
077788888887878888fcf888808788788887700
07777778777787888ccccc88808777788777700
077777777777878fcccccccf808777777777700
0777777777778788fcccccf88087777777c7700
0788777c7778878888fff888808877777778800
078888888888878888888888808888888888800
077777777777777777777777787777777777780
078888888888870808088888808888888888800
077888888887870888880880008788888878700
077777887777878888808888008777788777c00
077777777777870888888888008777777777700
07777777c7778788888088808087777777c7700
0788777c7778870888888088008877777778800
078888878888870000880800008888877888800
000000000000000000000000000000000000000